############################################################################################################################################################################
<@...........#.........##################.....................#.........................................................................#..................................#
<.......................################......................#..............................................#........####.####.........#..................................#
<............#...........##############.......................#..............................................#........##.....##............................................#
#...##########.........#..############..#.....................#.....#################........................#........##.....##............................................#
#............#.........##..##########..##.....................#.....................#........................#........#########.........#..................................#
##########...#.###.....###..########..###.....................#.....................#...................................................#..................................#
#............#...#.....####..######..####.....................#.....................#........................#############~##############..................................#
#...##########...#.....#####..####..#####.....................#.....................#........................~~~~~~~~~~~~~~~~~~~~~~~~~~~#..................................#
#............#...#.....######..##..######.....................#################.....#.......................#~~~~~~~~~~~~~~~~~~~~~~~~~~~#..................................#
##########...###.#.....#######....#######...........................................#.......................#~~~~~~~~~~~~~~~~~~~~~~~~~~~#..................................>
#............#...#.....########..########...........................................#.......................#~~~~~~~~~~~~~~~~~~~~~~~~~~~#..................................>
#................#.....##################...........................................#.......................#~~~~~~~~~~~~~~~~~~~~~~~~~~~...................................>
############################################################################################################################################################################