----------------------------------------------------------------------------------------------------------------------------------------------------------------------------
|            #         ##################                     #                                                                         #                                  |
|            +          ################                      #                                              #        #### ####         #                                  |
|            #           ##############                       #                                              #        ##     ##                                            |
|   ##########         #  ############  #                     #+++++#################                        #        ##     ##                                            |
|            #         ##  ##########  ##                     #                     #                        #        #########         #                                  |
|#########   # ###     ###  ########  ###                     #                     #                                                   #                                  |
|            #   #     ####  ######  ####                     #                     #                        #############~##############                                  |
|   ##########   #     #####  ####  #####                     #                     #                        ~~~~~~~~~~~~~~~~~~~~~~~~~~~#                                  |
|            #   #     ######  ##  ######                     #################     #                       #~~~~~~~~~~~~~~~~~~~~~~~~~~~#                                  |
|#########   ### #     #######    #######                                           #                       #~~~~~~~~~~~~~~~~~~~~~~~~~~~#                                  |
|            #   #     ########  ########                                           #                       #~~~~~~~~~~~~~~~~~~~~~~~~~~~#                                  |
|                #     ##################                                           #                       #~~~~~~~~~~~~~~~~~~~~~~~~~~~                                   |
----------------------------------------------------------------------------------------------------------------------------------------------------------------------------