###########################################################################
#         ##        ##########            ###########         ##          #
#   @     ##        ##########            ###########         ##          #
#                   #       ##            ###########         ##          #
####  ######        #       ##            ###########                     #
####  ######                ##            #                   ##          #
####           *    #####  ###            #                   ##        ###
####                               *      ###    #########  ####        ###
####                                             #########   ###    *   ###
########################################################                ###
#                           ##                         ###              ###
#               *           ##                  *        #######          #
#                           ##############                                #
########    #######                   ####         #      ######          #
########    #######                   ####        ##      ###########     #
########    #######                   ####       ###                      #
#                ##                            #####                      #
#     *          ##                           ######      #################
#             !  ##                   ##############      #################
###########################################################################