###########################################################################
#@        ##        ##########            ###########         ##          #
#         ##        ##########            ###########         ##          #
#                   #       ##            ###########         ##          #
####  ######        #       ##            ###########                     #
####  ######                ##            #                   ##          #
####                #####  ###            #                   ##        ###
####                                      ###    #########  ####        ###
####                                             #########   ###        ###
########################################################              ###
#                           ##                         ###              ###
#                           ##                           #######          #
#                           ##############                                #
########    #######                   ####         #      ######          #
########    #######                   ####        ##      ###########     #
########    #######                   ####       ###                      #
#                ##                            #####                      #
#                ##                           ######      #################
#                ##                   ##############      #################
###########################################################################